1111111111111111111111111
1PT000010000C0000010000I1
1011101011101110101110101
1000101000000000100010001
1010101111110111101111101
1I00100000000000000000001
1010111010111010111011101
1000000010000C00001000001
1011111111110111111111101
1000000000T00000000000001
10111011101110111011101T1
1C0000010000C000010000TE1
1011101011111110101110101
1000101000000000100010001
1010111111101111111111101
1T0000000000T0000000000C1
1111111111111111111111111