1111111111111111111111111
1P000000000000000000000C1
1011111111111111111111101
1C10000000000000000000I01
1010111111111111111111101
1010100000000000000000101
1010101111111T11111110101
1010100000000010000000101
1010111111111110111111101
1010000000000I00100000001
10111111111111111011111C1
1C000000000000000000000E1
1111111111111111111111111