1111111111111111111111111
1P00100C00000000000000001
1011101111111111111111101
100010000000001T000000101
1110111111111110111110101
1C0000000I000010000000101
1111111111111010111111101
1000000000001010000000001
10111111111110111111111C1
1010000000000000000I00001
1010C11111111111111111101
10000000000000000000001E1
1111111111111111111111111