1111111111111111111111111111111111111111
1000000000000000000000000000000000000001
1011111011111111011111110111111101111101
1000000100000000000010000000000010000001
1011101010111111111010111111111110111101
1I000000000000000000000000000000000000C1
1011111111011111111111111011111111111101
10000000P0010000000000001000000000000001
1011101111110111111011111011111011111101
1C00010000001000001000000000100000000001
1011111110111111111011111111111011111101
1T0000000000T0000000000C00000000000000E1
1111111111111111111110111111111111111101
1C00000000000000000000000000000000000001
1011101111111111111110111111111111111101
1T0000100000000000000T0000I00000000000C1
1011111111011111111011111111111111111101
1T00000000000000000000000000000000000001
1011111111111011111110111111111111111101
1C00000000000000000000000000000000000001
1011111111111111111111111111111111111101
1111111111111111111111111111111111111111
