1111111111111111111111111
1P00000000000000000000001
1011110111110111111111101
1T00010000010000000000001
1011011111011111110111101
1C00000100000100001000001
1011110111110111101111101
1T0000000000C000000000001
1011111111110111111111101
1000000000T0000000T000001
1011101110111011101110101
1C0000000000C0000T00000E1
1011110111111111111111101
1T00001000000000000000001
1011111111110111111111101
1C00000000000000000000001
1011011111011111110111101
1T0000000T0000010000T0001
1011110111110111101111101
1111111111111111111111111
